NO ./textures/redbrick.xpm
SO ./textures/STONE2.xpm
WE ./textures/brick_wall.xpm
EA ./textures/planks.xdpm

F 0,60,0
C 173,216,239

                         111111111
                        10000000001
                        10000000001
                         100000001
11111    111111111111111111000001
10001    100000000000000000000001
100011111101111111111111111000001
10001    100000000000000001111111
11011    111111111111111101                           111111
100011111110000000000000001                          10000001
10001000011011111111111111111111111111111           1000000001
1000000001101               1000000000001          100000000001
1001100001101               100000000000111111111110000000000001
100011111110111111          100000000000000000000000000001000001
100011000100100001          100000100000111111111110000000000001
100011000000000001          1000000000001          100000000001
10011100000000000111111111111000000000001           1000000001
10001100000000000000000000000000011111111            10000001
1000110000000000011111111111110001                    111111
110001100000000001           10001
100000000000000001           10001
100001100000000001           10001
100011000000000001           10001
110011000000000001          10001
100011000000000001         10001
100011000000000001        10001
100011111111111111       10001
10001            11111  10001
1001          11100000110001
101         110000000000001
101        10000000000000001
101       1000000000000000001
101111111100000111110000000003
1000000000000010000010000000001
1000000000000001112100000G000001
1111111111000000000000000000111
          100000000000000001
           10000000000000001
            1100000W0000011
              11100000111
                 10001
                 10001
        1111111111000111111111111
        10000000001100000000000Z1
        1011000001110000000000001
        1001000000000000000000001
111111111011000001110000000000001
100000000011000001110111111111111
11110111111111011100000010001
11110111111111011101010010001
11000000110101011100000010001
10000000000000001100000010001
10000000000000001101010010001
1100000111010101111101111000111
11110111 1110101 101111010001
11111111 1111111 111111111111
