NO ./textures/purplestone.xpm
SO ./textures/wood.xpm
WE ./textures/redbrick.xpm
EA ./textures/planks.xpm

F 128,128,128
C 255,160,122

1111111111111111
1000000000010001
1000000G00010001
100W000000010000
10000000000200001
10000010000100Z01
100000 0000010001
100000 0000001001
100000 0000000101
10000010000000001
10111111000000001
10001001000001
100010010000001
100010010000001
1111111113111111
