NO new_textures/simonkraft/wet_sponge.xpm
SO new_textures/simonkraft/wet_sponge.xpm
WE new_textures/simonkraft/wet_sponge.xpm
EA new_textures/simonkraft/wet_sponge.xpm

F 164,169,20
C 153,204,255


111111111111111111111
101000001000000000001
101010101011101110001
100010100010000010001
111110101111101011101
100000101000101000001
101111101011101111111
101000001010100000101
101011111010111110101
101010001010100010101
101110101010101010101
100000101010001010001
111111101011111011101
100000101000100010001
121110101110101110111
101000100000100010101
101011111111110110101
1G1010000000000010001
100110111011111111101
1N1000001000000000001
111111111111111111111